5
255 255 255
138 61 83
175 93 93
33 22 46
20 13 43
256
0 0 0 0 0 0 0 0 0 0 0 0 0 0 0 0 
0 0 0 0 0 0 0 0 0 0 0 0 0 0 0 0 
0 0 0 0 0 0 0 0 0 0 0 0 0 0 0 0 
0 0 0 0 0 0 0 0 0 0 0 0 0 0 0 0 
0 0 0 0 0 0 0 0 0 0 0 0 0 0 0 0 
0 0 0 0 0 1 1 1 1 1 1 0 0 0 0 0 
0 0 0 0 1 1 2 2 2 2 1 1 0 0 0 0 
0 0 0 1 1 2 2 1 1 2 2 1 1 0 0 0 
0 0 0 1 2 2 1 2 2 1 2 2 1 0 0 0 
0 0 0 1 2 2 1 2 2 1 2 2 1 0 0 0 
0 0 0 1 2 2 1 2 2 1 2 2 1 0 0 0 
0 0 0 1 2 2 1 2 2 1 2 2 1 0 0 0 
0 0 3 3 3 3 3 3 3 3 3 3 3 3 0 0 
0 3 3 3 3 3 3 3 3 3 3 3 3 3 3 0 
4 4 4 4 4 4 4 4 4 4 4 4 4 4 4 4 
4 4 4 4 4 4 4 4 4 4 4 4 4 4 4 4 

