16 16
800 300 2 2 16 16

16 16
0 0
40 1 0 
4
255 255 255
8 8 8
72 72 72
64 64 64

1
2304
0 0 0 0 0 0 0 1 1 1 0 0 0 0 0 0 
0 0 0 0 0 0 1 1 1 1 1 0 0 0 0 0 
0 0 0 0 0 0 1 1 2 1 1 3 0 0 0 0 
0 0 0 0 0 0 1 1 1 1 3 3 3 0 0 0 
0 0 0 0 0 0 1 1 1 1 0 0 0 0 0 0 
0 0 0 0 0 0 1 1 1 1 0 0 0 0 0 0 
0 0 0 0 0 1 1 1 1 1 1 0 0 0 0 0 
0 0 0 0 1 1 1 1 1 1 1 0 0 0 0 0 
0 0 0 1 1 1 1 1 1 1 1 0 0 0 0 0 
0 0 0 1 1 1 1 1 1 1 1 0 0 0 0 0 
0 0 1 1 1 1 1 1 1 1 1 0 0 0 0 0 
0 0 1 1 1 1 1 1 1 1 1 0 0 0 0 0 
0 1 1 1 1 1 1 1 1 1 0 0 0 0 0 0 
1 1 1 0 0 0 3 0 0 3 0 0 0 0 0 0 
0 0 0 0 0 0 3 0 0 3 0 0 0 0 0 0 
0 0 0 0 0 3 0 3 3 0 4 0 0 0 0 0 

0 0 1 0 0 0 0 0 0 0 0 0 0 1 0 0 
0 1 1 0 0 0 0 1 1 0 0 0 0 1 1 0 
0 1 1 1 0 0 1 1 1 1 0 0 1 1 1 0 
0 1 1 1 0 0 1 1 3 1 0 0 1 1 1 0 
0 1 1 1 1 0 1 1 1 1 3 0 1 1 1 0 
0 1 1 1 1 0 1 1 1 3 3 3 1 1 1 0 
0 0 1 1 1 1 1 1 1 1 1 1 1 1 0 0 
0 0 1 1 1 1 1 1 1 1 1 1 1 1 0 0 
0 0 0 0 1 1 1 1 1 1 1 1 0 0 0 0 
0 0 0 0 0 0 1 1 1 1 0 0 0 0 0 0 
0 0 0 0 0 0 1 3 1 3 0 0 0 0 0 0 
0 0 0 0 0 0 0 1 1 0 0 0 0 0 0 0 
0 0 0 0 0 0 1 1 1 1 0 0 0 0 0 0 
0 0 0 0 0 1 1 1 1 1 1 0 0 0 0 0 
0 0 0 0 1 0 1 0 1 0 1 0 0 0 0 0 
0 0 0 1 0 1 0 1 0 1 0 1 0 0 0 0 

0 0 0 0 0 0 0 1 1 0 0 0 0 0 0 0 
0 0 0 0 0 0 1 1 1 1 0 0 0 0 0 0 
0 0 0 0 0 0 1 1 3 1 0 0 0 0 0 0 
0 0 0 0 0 0 1 1 1 1 3 0 0 0 0 0 
0 0 0 0 0 0 1 1 1 3 3 3 0 0 0 0 
1 1 1 1 1 1 1 1 1 1 1 1 1 1 1 1 
0 1 1 1 1 1 1 1 1 1 1 1 1 1 1 0 
0 0 1 1 1 1 1 1 1 1 1 1 1 1 0 0 
0 0 0 0 1 1 1 1 1 1 1 1 0 0 0 0 
0 0 0 0 0 0 1 3 1 3 0 0 0 0 0 0 
0 0 0 0 0 0 0 1 1 0 0 0 0 0 0 0 
0 0 0 0 0 0 1 1 1 1 0 0 0 0 0 0 
0 0 0 0 0 1 1 1 1 1 1 0 0 0 0 0 
0 0 0 0 1 0 1 0 1 0 1 0 0 0 0 0 
0 0 0 1 0 1 0 1 0 1 0 1 0 0 0 0 
0 0 0 0 0 0 0 0 0 0 0 0 0 0 0 0 

0 0 0 0 0 0 0 0 0 0 0 0 0 0 0 0 
0 0 0 0 0 0 1 1 0 0 0 0 0 0 0 0 
0 0 0 0 0 1 1 1 1 0 0 0 0 0 0 0 
0 0 0 0 0 1 1 3 1 0 0 0 0 0 0 0 
0 0 0 0 0 1 1 1 1 3 0 0 0 0 0 0 
0 0 0 0 0 1 1 1 3 3 3 0 0 0 0 0 
0 0 1 1 1 1 1 1 1 1 1 1 0 0 0 0 
0 1 1 1 1 1 1 1 1 1 1 1 1 0 0 0 
0 1 1 1 1 1 1 1 1 1 1 1 1 0 0 0 
1 1 1 0 0 1 1 1 1 0 0 1 1 1 0 0 
1 1 0 0 0 1 3 1 3 0 0 0 1 1 1 0 
1 1 0 0 0 0 1 1 0 0 0 0 1 1 1 0 
0 0 0 0 0 1 1 1 1 0 0 0 0 0 1 0 
0 0 0 0 1 1 1 1 1 1 0 0 0 0 0 0 
0 0 0 1 0 1 0 1 0 1 0 0 0 0 0 0 
0 0 1 0 1 0 1 0 1 0 1 0 0 0 0 0 

0 0 0 0 0 0 0 0 0 0 0 0 0 0 0 0 
0 0 0 0 0 0 0 1 1 0 0 0 0 0 0 0 
0 0 0 0 0 0 1 1 1 1 0 0 0 0 0 0 
0 0 0 0 0 0 1 1 3 1 0 0 0 0 0 0 
0 0 0 0 0 0 1 1 1 1 3 0 0 0 0 0 
0 0 0 0 0 0 1 1 1 3 3 3 0 0 0 0 
1 1 1 1 1 1 1 1 1 1 1 1 1 1 1 1 
0 1 1 1 1 1 1 1 1 1 1 1 1 1 1 0 
0 0 1 1 1 1 1 1 1 1 1 1 1 1 0 0 
0 0 0 0 1 1 1 1 1 1 1 1 0 0 0 0 
0 0 0 0 0 0 1 3 1 3 0 0 0 0 0 0 
0 0 0 0 0 0 0 1 1 0 0 0 0 0 0 0 
0 0 0 0 0 0 1 1 1 1 0 0 0 0 0 0 
0 0 0 0 0 1 1 1 1 1 1 0 0 0 0 0 
0 0 0 0 1 0 1 0 1 0 1 0 0 0 0 0 
0 0 0 1 0 1 0 1 0 1 0 1 0 0 0 0 

0 0 0 0 0 0 0 0 0 0 0 0 0 0 0 0 
0 0 1 0 0 0 0 0 0 0 0 0 0 1 0 0 
0 1 1 0 0 0 0 1 1 0 0 0 0 1 1 0 
0 1 1 1 0 0 1 1 1 1 0 0 1 1 1 0 
0 1 1 1 0 0 1 1 3 1 0 0 1 1 1 0 
0 1 1 1 1 0 1 1 1 1 3 0 1 1 1 0 
0 1 1 1 1 0 1 1 1 3 3 3 1 1 1 0 
0 0 1 1 1 1 1 1 1 1 1 1 1 1 0 0 
0 0 1 1 1 1 1 1 1 1 1 1 1 1 0 0 
0 0 0 0 1 1 1 1 1 1 1 1 0 0 0 0 
0 0 0 0 0 1 1 1 1 1 0 0 0 0 0 0 
0 1 1 1 1 1 1 1 1 3 0 0 0 0 0 0 
0 0 1 1 1 1 1 3 0 0 0 0 0 0 0 0 
0 0 0 1 1 1 0 0 0 0 0 0 0 0 0 0 
0 0 0 0 1 1 0 0 0 0 0 0 0 0 0 0 
0 0 0 0 0 1 0 0 0 0 0 0 0 0 0 0 

0 0 0 0 0 0 0 0 1 1 0 0 0 0 0 0 
0 0 0 0 0 0 0 1 1 1 1 0 0 0 0 0 
0 0 0 0 0 0 0 1 1 3 1 0 0 0 0 0 
0 0 0 0 0 0 0 1 1 1 1 3 0 0 0 0 
0 0 0 0 0 0 0 1 1 1 3 3 3 0 0 0 
0 1 1 1 1 1 1 1 1 1 1 1 1 1 1 1 
0 0 1 1 1 1 1 1 1 1 1 1 1 1 1 1 
0 0 0 1 1 1 1 1 1 1 1 1 1 1 1 0 
0 0 0 0 0 0 1 1 1 1 1 0 0 0 0 0 
0 0 1 1 1 1 1 1 1 1 3 0 0 0 0 0 
0 0 0 1 1 1 1 1 3 0 0 0 0 0 0 0 
0 0 0 0 1 1 1 0 0 0 0 0 0 0 0 0 
0 0 0 0 0 1 1 0 0 0 0 0 0 0 0 0 
0 0 0 0 0 0 1 0 0 0 0 0 0 0 0 0 
0 0 0 0 0 0 0 0 0 0 0 0 0 0 0 0 
0 0 0 0 0 0 0 0 0 0 0 0 0 0 0 0 

0 0 0 0 0 0 0 0 0 0 0 0 0 0 0 0 
0 0 0 0 0 1 1 0 0 0 0 0 0 0 0 0 
0 0 0 0 1 1 1 1 0 0 0 0 0 0 0 0 
0 0 0 0 1 1 3 1 0 0 0 0 0 0 0 0 
0 0 0 0 1 1 1 1 3 0 0 0 0 0 0 0 
0 0 0 0 1 1 1 3 3 3 0 0 0 0 0 0 
0 1 1 1 1 1 1 1 1 1 1 0 0 0 0 0 
1 1 1 1 1 1 1 1 1 1 1 1 0 0 0 0 
1 1 1 1 1 1 1 1 1 1 1 1 0 0 0 0 
1 1 0 1 1 1 1 1 0 0 1 1 1 0 0 0 
1 1 1 1 1 1 1 3 0 0 0 1 1 1 0 0 
1 1 1 1 1 3 0 0 0 0 0 1 1 1 0 0 
0 1 1 1 0 0 0 0 0 0 0 0 0 1 0 0 
0 0 1 1 0 0 0 0 0 0 0 0 0 0 0 0 
0 0 0 1 0 0 0 0 0 0 0 0 0 0 0 0 
0 0 0 0 0 0 0 0 0 0 0 0 0 0 0 0 

0 0 0 0 0 0 0 0 0 0 0 0 0 0 0 0 
0 0 0 0 0 1 1 0 0 0 0 0 0 0 0 0 
0 0 0 0 1 1 1 1 0 0 0 0 0 0 0 0 
0 0 0 0 1 1 3 1 0 0 0 0 0 0 0 0 
0 0 0 0 1 1 1 1 3 0 0 0 0 0 0 0 
0 0 0 0 1 1 1 3 3 3 0 0 0 0 0 0 
1 1 1 1 1 1 1 1 1 1 1 1 1 1 0 0 
1 1 1 1 1 1 1 1 1 1 1 1 1 0 0 0 
1 1 1 1 1 1 1 1 1 1 1 1 0 0 0 0 
0 0 0 1 1 1 1 1 0 0 0 0 0 0 0 0 
1 1 1 1 1 1 1 3 0 0 0 0 0 0 0 0 
1 1 1 1 1 3 0 0 0 0 0 0 0 0 0 0 
0 1 1 1 0 0 0 0 0 0 0 0 0 0 0 0 
0 0 1 1 0 0 0 0 0 0 0 0 0 0 0 0 
0 0 0 1 0 0 0 0 0 0 0 0 0 0 0 0 
0 0 0 0 0 0 0 0 0 0 0 0 0 0 0 0