16 16
800 300 2 2 16 16

16 16
0 0
4 1 0

4
8 8 8
68 170 153
119 255 153
255 255 255

1
1280
0 0 0 0 0 0 1 1 1 1 0 0 0 0 0 0 
0 0 0 0 1 1 2 2 2 2 1 1 0 0 0 0 
0 0 0 1 2 2 3 3 3 3 2 2 1 0 0 0 
0 0 1 2 3 3 3 3 3 3 3 3 2 1 0 0 
0 1 2 3 3 3 3 3 3 3 3 3 3 2 1 0 
0 1 2 3 3 3 3 3 3 3 3 3 3 2 1 0 
1 2 3 3 3 3 3 3 3 3 3 3 3 3 2 1 
1 2 3 3 3 3 3 3 3 3 3 3 3 3 2 1 
1 2 3 3 3 3 3 3 3 3 3 3 3 3 2 1 
1 2 3 3 3 3 3 3 3 3 3 3 3 3 2 1 
0 1 2 3 3 3 3 3 3 3 3 3 3 2 1 0 
0 1 2 3 3 3 3 3 3 3 3 3 3 2 1 0 
0 0 1 2 3 3 3 3 3 3 3 3 2 1 0 0 
0 0 0 1 2 2 3 3 3 3 2 2 1 0 0 0 
0 0 0 0 1 1 2 2 2 2 1 1 0 0 0 0 
0 0 0 0 0 0 1 1 1 1 0 0 0 0 0 0 

0 0 0 0 0 0 1 1 0 1 0 0 0 0 0 0 
0 0 0 0 1 0 2 2 2 2 0 1 0 0 0 0 
0 0 0 0 2 0 3 3 3 3 2 0 1 0 0 0 
0 0 1 2 3 3 3 0 3 3 0 3 2 1 0 0 
0 0 2 3 0 0 3 3 3 3 0 3 3 2 1 0 
0 1 2 3 0 3 3 3 0 3 3 3 3 0 0 0 
1 0 0 3 3 0 3 3 3 3 3 0 3 3 0 1 
1 2 3 0 3 3 3 0 3 0 3 0 0 0 2 1 
1 2 0 0 3 3 0 3 3 3 3 3 0 3 2 0 
0 2 0 3 3 0 0 0 3 0 3 3 3 0 2 1 
0 1 2 3 3 0 3 3 0 3 0 3 0 2 1 0 
0 0 2 3 3 3 3 0 3 3 3 3 3 2 1 0 
0 0 1 0 3 0 3 3 3 3 0 3 0 0 0 0 
0 0 0 1 2 2 0 3 0 3 2 2 1 0 0 0 
0 0 0 0 1 1 0 2 2 2 1 0 0 0 0 0 
0 0 0 0 0 0 1 1 0 1 0 0 0 0 0 0 

0 0 0 0 0 0 0 0 0 0 0 0 0 0 0 0 
0 0 0 0 0 1 0 0 0 0 1 0 0 0 0 0 
0 0 0 0 0 0 2 0 3 0 2 0 1 0 0 0 
0 0 1 0 0 3 0 3 0 0 0 3 2 0 0 0 
0 0 2 0 3 0 3 0 0 3 3 3 0 2 0 0 
0 1 2 0 0 3 3 0 3 0 3 0 0 0 1 0 
0 0 0 3 0 0 0 3 3 0 0 0 3 0 0 0 
1 2 0 3 0 3 0 0 3 3 3 0 3 0 2 0 
0 2 3 0 0 0 3 0 0 3 0 3 3 0 2 0 
1 2 3 0 3 0 0 0 3 0 0 3 0 0 0 1 
0 1 2 3 3 3 0 3 0 3 0 0 0 3 0 0 
0 0 0 3 0 3 0 3 0 0 0 0 3 0 1 0 
0 0 0 2 0 0 0 3 3 3 0 0 2 1 0 0 
0 0 0 0 2 0 3 3 0 0 2 0 1 0 0 0 
0 0 0 0 0 0 2 0 0 2 1 0 0 0 0 0 
0 0 0 0 0 0 0 0 0 0 0 0 0 0 0 0 

0 0 0 0 0 0 0 0 0 0 0 0 0 0 0 0 
0 0 0 0 0 0 0 0 1 0 0 0 0 0 0 0 
0 0 0 0 0 0 1 2 0 2 1 0 0 0 0 0 
0 0 0 1 0 2 0 0 2 0 0 2 0 0 0 0 
0 0 0 0 2 3 0 3 0 0 3 0 2 1 0 0 
0 0 1 0 3 0 0 0 3 0 0 0 0 0 0 0 
0 0 2 0 0 3 0 3 0 3 0 3 0 2 0 0 
0 1 0 2 0 0 0 0 3 0 0 0 3 0 1 0 
0 0 0 0 0 3 0 0 0 0 0 0 0 2 0 0 
0 1 0 2 3 0 3 0 0 3 0 3 0 0 0 0 
0 0 0 0 0 0 0 0 3 3 3 0 2 1 0 0 
0 0 1 2 0 3 0 3 0 3 0 2 0 0 0 0 
0 0 0 0 2 0 0 0 2 0 0 0 1 0 0 0 
0 0 0 0 1 0 2 2 0 0 1 0 0 0 0 0 
0 0 0 0 0 0 1 0 1 0 0 0 0 0 0 0 
0 0 0 0 0 0 0 0 0 0 0 0 0 0 0 0 

0 0 0 0 0 0 0 0 0 0 0 0 0 0 0 0 
0 0 0 0 0 0 0 0 0 0 0 0 0 0 0 0 
0 0 0 0 0 0 0 2 0 0 0 0 0 0 0 0 
0 0 0 0 0 1 0 0 0 0 2 0 1 0 0 0 
0 0 0 0 2 0 0 3 0 0 0 0 0 0 0 0 
0 0 2 0 0 0 0 0 0 0 0 0 0 2 0 0 
0 0 0 0 3 0 0 0 3 0 0 3 0 0 0 0 
0 0 0 1 0 0 3 0 0 0 0 0 0 0 2 0 
0 2 0 0 3 0 0 0 0 0 3 0 0 0 0 0 
0 0 0 0 0 0 0 3 0 0 0 0 3 0 0 0 
0 0 0 2 0 0 0 0 0 3 0 3 0 0 0 0 
0 0 0 0 0 0 3 0 0 0 0 0 1 0 0 0 
0 0 0 0 1 0 0 0 0 0 2 0 0 0 0 0 
0 0 0 0 0 0 0 2 0 0 0 0 0 0 0 0 
0 0 0 0 0 0 0 0 0 0 0 0 0 0 0 0 
0 0 0 0 0 0 0 0 0 0 0 0 0 0 0 0 
