8 8  
500 100 2 2  
16 16

6
14 4 4 1
15 4 4 1
16 16 2 1
14 4 4 1
15 4 4 1
0 1  30 1