16 16
800 300 2 2 16 16

16 16
0 0
80 1 0

16
255 255 255
130 1 1
101 0 0
199 158 20
142 110 0
106 85 11
81 0 0

0 0 0
0 0 0
0 0 0
0 0 0
0 0 0
0 0 0
0 0 0
0 0 0
0 0 0

1
256
0 0 0 0 0 1 0 0 0 0 0 0 0 0 0 0 
0 0 0 0 1 2 0 0 0 0 0 0 0 0 0 0 
0 0 0 1 2 2 0 0 0 0 0 0 0 0 0 0 
0 0 0 2 2 2 0 0 0 0 0 0 0 0 0 0 
0 0 0 2 2 2 0 0 0 0 0 0 0 0 0 0 
0 0 0 2 2 2 3 3 3 3 3 3 3 0 0 0 
0 0 0 2 2 2 0 0 0 0 4 0 0 0 0 0 
0 0 0 4 3 3 3 3 3 3 3 0 0 0 0 0 
0 0 0 4 2 1 1 1 4 1 1 2 0 0 0 0 
0 0 0 4 1 1 1 1 4 1 2 5 0 0 0 0 
0 0 0 4 6 6 6 6 6 2 0 5 0 0 0 0 
0 0 0 4 0 5 0 0 0 4 0 4 0 0 0 0 
0 0 0 4 0 5 0 0 0 4 0 4 0 0 0 0 
0 0 0 4 0 4 0 0 0 4 0 4 0 0 0 0 
0 0 0 4 0 0 0 0 0 4 0 0 0 0 0 0 
0 0 0 4 0 0 0 0 0 4 0 0 0 0 0 0