16 16
800 300 2 2 16 16

16 16
0 0
80 1 0

16
255 255 255
127 74 31
136 86 45
67 40 18
243 32 32
243 162 81
243 243 0
164 131 17
174 137 9
108 61 22

0 0 0
0 0 0
0 0 0
0 0 0
0 0 0
0 0 0

1
256
0 0 0 0 1 1 2 2 2 2 1 1 0 0 0 0 
0 0 1 1 1 1 1 1 1 1 1 1 1 1 0 0 
0 0 1 3 3 3 3 4 4 3 3 3 3 1 0 0 
0 0 1 3 3 4 3 4 5 4 3 3 3 1 0 0 
0 0 1 3 3 4 3 4 6 4 3 3 4 1 0 0 
0 2 1 3 3 4 4 5 6 4 3 4 4 1 2 0 
0 2 1 4 3 4 5 5 6 5 4 4 4 1 2 0 
0 2 1 4 4 5 6 6 6 5 5 5 4 1 2 0 
0 2 1 3 4 6 5 6 6 5 6 5 3 1 2 0 
0 2 1 4 4 5 6 6 6 6 5 5 4 1 2 0 
0 2 1 3 4 4 5 6 6 6 5 4 3 1 2 0 
0 0 1 7 8 8 5 5 5 5 8 8 7 1 0 0 
0 0 1 9 9 7 8 7 9 8 8 7 9 1 0 0 
0 0 1 9 7 8 9 7 7 9 9 8 7 1 0 0 
0 0 1 1 1 1 1 1 1 1 1 1 1 1 0 0 
0 0 1 1 0 0 0 0 0 0 0 0 1 1 0 0