16 16
800 300 2 2 16 16

16 16
0 0
80 1 0

16
255 255 255
189 204 251
154 183 255
105 119 255
186 186 247
0 0 227
114 107 165
0 0 162
156 147 142
95 86 80
74 68 64
116 107 102

0 0 0
0 0 0
0 0 0
0 0 0

1
256
0 0 0 1 0 0 1 1 1 1 1 0 1 0 0 0 
0 0 1 1 1 0 0 2 2 2 0 1 1 1 0 0 
0 0 1 0 2 3 0 0 3 0 0 2 0 1 0 0 
0 0 0 0 0 3 0 3 3 0 3 3 0 0 0 0 
0 0 0 0 4 5 4 5 4 0 3 0 0 0 0 0 
0 0 0 4 4 5 4 5 4 4 5 4 0 0 0 0 
0 0 4 4 4 5 6 5 6 6 5 4 4 0 0 0 
0 0 0 6 6 5 7 5 7 7 5 6 0 0 0 0 
0 0 8 7 7 5 7 5 7 7 7 7 8 0 0 0 
0 0 9 8 8 7 7 5 7 7 8 8 9 0 0 0 
0 0 9 10 10 8 8 8 8 8 11 11 9 0 0 0 
0 0 9 10 10 9 9 11 11 11 11 11 9 0 0 0 
0 0 9 10 10 9 11 11 11 11 11 11 9 0 0 0 
0 0 9 10 10 9 9 11 11 11 11 11 9 0 0 0 
0 0 0 10 10 9 11 11 11 11 11 11 0 0 0 0 
0 0 0 0 0 9 9 11 11 11 0 0 0 0 0 0  