16 16
800 300 2 2 16 16

16 16
0 0
80 1 0

16
200 200 200

4 4 9
108 66 87
166 138 125
70 138 200
57 64 127
46 32 60
192 118 53
133 56 56
216 210 192
86 41 66
29 63 46
51 117 68
86 171 73
236 217 152
186 224 113

1
2304
0 0 0 0 1 1 1 1 1 1 0 0 0 0 0 0 
0 0 0 1 2 3 3 3 3 2 1 0 0 0 0 0 
0 0 0 1 3 9 3 3 3 3 1 0 0 0 0 0 
0 0 0 1 3 3 3 3 3 3 2 1 0 0 0 0 
0 0 9 9 9 9 9 9 3 9 9 1 1 0 0 0 
0 0 1 6 6 2 6 6 3 9 2 1 1 1 0 0 
0 1 2 9 9 9 3 3 3 2 3 1 8 1 1 0 
0 1 9 2 2 6 9 3 3 3 3 1 8 8 1 0 
0 1 2 3 3 3 3 3 3 2 1 6 8 2 1 1 
0 0 6 9 9 3 2 2 6 6 6 6 2 8 6 1 
0 1 9 9 3 6 1 1 6 1 1 8 8 2 6 1 
1 9 3 10 10 1 3 3 1 3 2 1 2 10 1 1 
0 1 1 1 10 1 2 7 7 6 3 1 10 1 1 0 
0 0 0 0 1 1 1 8 1 1 1 1 6 1 0 0 
0 0 0 0 0 1 1 7 1 0 0 1 6 1 0 0 
0 0 0 0 1 1 1 8 1 0 0 0 1 1 1 0 

0 0 0 0 0 1 1 1 1 1 1 0 0 0 0 0 
0 0 0 0 1 4 2 4 2 5 6 1 0 0 0 0 
0 0 0 0 1 3 3 3 3 1 1 2 0 0 0 0 
0 0 0 6 3 6 6 3 1 9 3 1 1 6 0 0 
0 0 6 1 6 9 3 1 1 3 9 1 2 1 0 0 
0 0 1 2 6 3 9 8 6 1 1 2 1 6 0 0 
0 0 6 1 3 6 6 8 8 6 3 2 0 0 0 0 
0 0 0 1 6 3 3 8 8 6 2 6 1 1 0 0 
0 0 1 1 1 2 3 6 6 6 2 1 6 5 1 0 
0 1 4 5 6 1 2 3 3 2 1 6 5 5 1 0 
0 1 4 4 5 6 1 3 3 2 6 1 5 5 1 0 
0 1 4 4 5 1 5 6 1 1 5 1 2 2 1 0 
0 1 1 1 1 1 5 5 5 5 6 1 6 2 1 0 
0 1 3 3 2 1 1 1 1 1 1 1 1 1 0 0 
0 0 1 6 1 1 6 1 0 1 6 1 1 0 0 0 
0 0 0 0 1 1 1 1 0 1 1 6 1 1 0 0 

0 0 1 1 0 1 1 1 1 1 0 0 1 0 0 0 
1 1 1 7 8 3 7 7 7 8 1 1 7 1 0 0 
1 7 1 1 7 7 7 7 7 7 8 7 7 1 0 0 
0 1 7 8 10 1 1 7 6 6 8 7 8 1 0 0 
0 0 1 8 1 9 1 2 9 1 6 1 1 1 0 0 
0 0 1 6 1 1 5 3 1 5 6 6 1 7 1 0 
0 1 1 2 9 1 5 3 1 5 8 10 1 8 7 1 
1 7 7 1 2 3 3 3 3 3 2 1 1 1 1 0 
0 1 7 1 1 2 10 8 3 2 1 1 10 1 0 0 
0 0 1 3 8 10 1 1 1 6 6 1 8 1 6 0 
0 1 3 2 10 8 8 8 10 2 10 6 1 8 1 1 
1 3 3 1 10 8 8 10 8 10 2 10 6 1 2 1 
1 3 3 6 8 8 8 8 10 10 2 8 10 2 2 1 
0 6 6 0 1 11 11 0 0 0 11 11 1 6 6 0 
0 0 0 1 6 1 1 0 0 0 1 1 6 1 0 0 
0 0 1 2 1 0 1 0 0 0 1 0 1 2 1 0 

0 0 0 0 0 0 0 0 0 0 0 0 0 0 0 0 
0 0 0 0 0 0 1 1 0 0 0 1 1 0 0 0 
0 1 1 0 0 0 1 2 1 0 0 1 6 1 0 0 
0 1 2 1 0 0 1 6 10 1 0 0 1 6 1 0 
0 1 6 2 1 1 1 6 2 1 0 0 1 6 1 0 
0 1 6 2 6 10 10 6 10 1 0 0 1 2 1 0 
0 0 6 1 2 2 1 10 6 1 0 0 1 2 1 0 
1 1 1 1 2 2 1 6 6 1 1 1 1 6 1 0 
1 6 6 2 2 10 2 10 6 1 6 10 6 6 1 0 
1 10 10 2 2 2 10 10 6 1 10 2 10 6 1 0 
0 1 6 6 6 10 10 1 1 6 2 2 10 6 1 0 
0 1 8 8 1 1 1 1 6 10 10 10 10 6 6 1 
0 0 1 1 6 6 1 10 6 6 1 1 1 6 6 1 
1 1 10 6 1 1 10 6 6 1 1 1 1 6 6 1 
1 10 6 1 1 10 6 6 1 1 6 1 1 6 6 1 
1 1 1 0 1 1 1 1 0 1 1 0 1 1 1 0 

0 0 0 0 0 0 0 0 0 0 0 0 0 0 0 0 
0 0 0 0 0 0 0 0 0 0 0 0 0 0 0 0 
0 0 0 0 0 0 0 0 0 0 0 0 0 0 0 0 
0 0 0 1 1 11 1 1 1 0 0 0 0 0 0 0 
0 0 1 13 12 12 12 13 13 1 1 0 0 0 0 0 
0 0 1 12 13 13 12 1 1 13 11 1 0 0 0 0 
0 1 12 13 13 13 13 12 13 13 12 11 1 0 0 0 
0 1 11 1 11 11 1 12 13 13 12 13 11 1 0 0 
0 0 1 12 13 13 13 12 11 12 13 12 12 1 0 0 
0 0 0 1 11 12 6 11 12 6 11 11 12 11 1 0 
0 0 0 1 12 6 11 12 6 11 13 12 11 11 1 0 
0 0 1 13 1 1 13 11 1 11 12 12 12 11 1 0 
0 11 13 11 11 13 11 1 1 1 6 11 11 11 1 0 
0 1 11 0 1 11 1 1 11 12 12 11 1 1 0 0 
0 0 0 0 0 0 0 1 1 1 1 1 0 0 0 0 
0 0 0 0 0 0 0 0 0 0 0 0 0 0 0 0 

0 0 0 0 0 0 0 0 0 0 0 0 0 0 0 0 
0 0 0 0 0 0 0 0 0 0 0 0 0 0 0 0 
0 0 0 0 0 6 1 1 1 0 0 0 0 0 0 0 
0 0 0 0 1 11 12 12 11 1 0 0 0 0 0 0 
0 0 0 1 7 12 2 1 12 11 1 0 0 0 0 0 
0 0 1 7 2 12 1 5 12 12 1 0 0 0 0 0 
0 1 2 7 7 12 12 13 12 12 1 0 0 0 0 0 
0 6 1 1 6 11 12 12 12 11 1 0 0 1 6 0 
0 0 0 0 1 10 2 2 2 6 1 1 1 12 1 0 
0 0 0 0 1 10 6 2 3 3 2 10 6 2 1 0 
0 0 0 0 1 10 6 2 3 2 3 6 2 10 1 0 
0 0 0 0 1 6 2 10 6 6 6 2 10 6 1 0 
0 0 0 0 0 1 6 2 10 10 10 10 6 1 0 0 
0 0 0 0 0 0 1 1 1 1 1 1 1 0 0 0 
0 0 0 0 0 0 0 1 8 7 1 0 0 0 0 0 
0 0 0 0 0 0 0 0 0 0 0 0 0 0 0 0 

0 0 0 0 0 0 1 1 1 1 0 0 0 0 0 0 
0 0 0 0 1 11 13 13 12 11 1 0 0 0 0 0 
0 0 0 1 12 13 13 13 13 12 11 1 1 1 0 0 
0 0 0 1 11 11 6 3 6 12 11 12 12 12 1 0 
0 0 1 13 13 12 11 6 13 12 11 11 12 1 0 0 
0 1 13 13 12 11 12 11 13 12 11 12 1 1 1 0 
0 0 1 1 11 1 11 12 12 12 1 6 6 6 1 0 
0 0 1 11 13 12 12 11 12 1 6 1 11 12 12 1 
0 1 1 11 12 12 12 12 12 1 6 1 11 12 12 1 
0 11 1 1 1 1 11 1 1 1 6 1 1 12 11 1 
1 11 1 6 1 6 10 6 1 6 1 11 11 1 1 0 
1 12 1 6 1 2 2 2 1 1 12 12 12 12 1 0 
1 12 11 1 8 8 7 7 8 1 11 12 12 12 1 0 
0 1 1 1 1 1 1 1 1 6 1 11 11 1 0 0 
0 0 0 1 6 6 1 1 0 0 1 1 6 6 1 0 
0 0 1 1 1 1 6 1 0 0 1 6 1 1 1 0 

0 0 0 0 1 1 0 0 0 0 1 1 0 0 0 0 
0 0 0 1 8 1 0 0 0 0 1 10 1 0 0 0 
0 0 1 8 1 0 0 0 0 0 0 1 10 1 0 0 
0 0 1 8 6 1 1 1 1 1 1 1 10 1 0 0 
0 0 1 10 10 8 8 8 8 1 6 8 6 1 0 0 
0 0 1 10 8 6 6 6 1 15 13 6 10 1 1 1 
1 1 1 8 6 15 13 6 6 13 12 1 10 1 10 1 
1 10 10 8 10 13 12 10 8 1 8 8 10 1 1 0 
0 1 10 8 10 8 10 1 6 6 1 8 6 1 0 0 
0 0 1 1 8 8 8 8 8 8 8 6 1 0 0 0 
0 0 1 10 6 1 6 6 6 6 1 6 1 1 0 0 
0 1 8 8 1 6 10 8 10 10 10 1 6 6 1 0 
0 1 8 10 1 6 8 10 6 2 10 1 1 6 1 0 
0 1 1 1 1 11 12 12 11 11 11 1 1 1 1 0 
0 0 0 0 1 12 1 1 1 1 11 1 0 0 0 0 
0 0 0 1 1 1 0 0 0 0 1 1 1 0 0 0 

0 1 1 0 0 0 0 1 1 0 0 0 0 1 1 0 
0 1 9 6 1 6 1 5 5 1 6 1 6 14 1 0 
0 1 14 14 3 1 5 1 1 6 1 3 14 3 1 0 
0 1 1 6 6 5 4 4 4 4 5 1 6 1 1 0 
0 0 1 1 5 4 5 4 4 5 4 5 1 1 0 0 
0 1 4 5 4 6 6 4 4 6 6 5 1 5 1 0 
1 4 5 6 4 3 2 5 5 2 3 5 1 6 5 1 
1 4 4 1 5 4 4 4 4 4 5 6 1 5 5 1 
1 5 4 5 1 4 6 4 4 6 5 1 6 5 6 1 
1 4 5 6 1 2 9 16 9 3 2 1 1 6 5 1 
1 4 4 4 6 1 5 4 4 5 1 1 5 5 5 1 
1 4 4 5 10 6 10 10 10 10 6 1 6 5 5 1 
1 5 4 1 6 10 7 14 3 7 10 1 1 5 6 1 
0 1 1 1 1 1 6 6 1 1 6 1 1 1 1 0 
0 0 0 1 2 1 1 0 0 0 1 2 1 1 0 0 
0 0 0 1 0 1 1 0 0 0 1 6 0 1 0 0