16 16
800 300 2 2 16 16

16 16
0 0
80 1 0

16
255 255 255
8 8 8
141 203 255
33 131 217
38 107 168
80 165 235
21 45 67

0 0 0
0 0 0
0 0 0
0 0 0
0 0 0
0 0 0
0 0 0
0 0 0
0 0 0

1
256
0 0 0 0 0 0 0 0 0 0 0 0 0 0 0 0 
0 0 0 0 0 0 1 1 1 1 0 0 0 0 0 0 
0 0 0 0 1 1 0 2 2 0 1 1 0 0 0 0 
0 0 0 1 3 4 5 2 2 5 4 3 1 0 0 0 
0 0 1 5 5 3 3 5 5 3 3 5 5 1 0 0 
0 0 1 0 5 5 4 5 5 4 5 5 0 1 0 0 
0 1 2 1 1 1 5 2 2 5 1 1 1 2 1 0 
0 1 5 1 6 6 1 2 2 1 6 6 1 5 1 0 
0 1 3 2 1 1 1 2 2 1 1 1 2 3 1 0 
0 1 3 3 2 5 2 5 5 2 5 2 3 3 1 0 
0 1 6 3 3 5 3 3 3 3 5 3 3 6 1 0 
0 0 1 4 3 5 4 1 1 4 5 3 4 1 0 0 
0 0 1 6 3 5 1 6 6 1 5 3 6 1 0 0 
0 0 1 6 4 3 1 1 1 1 3 4 6 1 0 0 
0 0 0 1 6 4 1 0 0 1 4 6 1 0 0 0 
0 0 0 0 1 1 0 0 0 0 1 1 0 0 0 0 