16 16
800 300 2 2 16 16

16 16
0 0
80 1 0

16
255 255 255
8 8 8
255 209 69
203 143 24
179 95 14

0 0 0
0 0 0
0 0 0
0 0 0
0 0 0
0 0 0
0 0 0
0 0 0
0 0 0
0 0 0
0 0 0

1
256
0 0 0 0 0 0 0 1 1 1 0 0 0 0 0 0 
0 0 0 0 0 0 1 2 2 2 1 0 0 0 0 0 
0 0 0 0 0 1 2 3 1 3 3 1 0 0 0 0 
0 0 0 0 0 1 2 1 0 1 3 1 0 0 0 0 
0 0 0 0 0 1 3 4 1 3 4 1 0 0 0 0 
0 0 0 0 0 0 1 3 2 4 1 0 0 0 0 0 
0 0 0 0 0 0 0 1 4 1 0 0 0 0 0 0 
0 0 0 0 0 0 0 1 3 1 0 0 0 0 0 0 
0 0 0 0 0 0 0 1 3 1 0 0 0 0 0 0 
0 0 0 0 0 0 1 1 3 1 0 0 0 0 0 0 
0 0 0 0 0 0 1 2 3 1 0 0 0 0 0 0 
0 0 0 0 0 0 0 1 3 1 0 0 0 0 0 0 
0 0 0 0 0 1 1 1 4 1 0 0 0 0 0 0 
0 0 0 0 0 1 2 3 3 1 0 0 0 0 0 0 
0 0 0 0 0 1 1 1 4 1 0 0 0 0 0 0 
0 0 0 0 0 0 0 1 1 1 0 0 0 0 0 0 