16 16
800 300 2 2 16 16

16 16
0 0
80 1 0

16
255 255 255
235 214 98
206 174 0
114 131 145
142 168 190
173 150 26
94 114 130

0 0 0
0 0 0
0 0 0
0 0 0
0 0 0
0 0 0
0 0 0
0 0 0
0 0 0

1
256
0 0 0 0 0 1 1 1 1 1 1 0 0 0 0 0 
0 0 0 0 1 2 3 3 3 3 2 1 0 0 0 0 
0 0 1 0 2 3 3 3 3 4 4 2 0 1 0 0 
0 0 2 5 2 3 3 3 4 4 3 2 5 2 0 0 
0 0 2 0 2 3 3 4 4 3 3 2 0 2 0 0 
0 0 2 0 2 3 4 4 3 3 6 2 0 2 0 0 
0 0 2 0 2 4 4 3 3 6 6 2 0 2 0 0 
0 0 2 0 2 4 3 3 6 6 3 2 0 2 0 0 
0 0 2 0 2 3 3 6 6 3 3 2 0 2 0 0 
0 0 2 0 2 3 6 6 3 3 3 2 0 2 0 0 
0 0 2 0 2 6 6 3 3 3 3 2 0 2 0 0 
0 0 2 0 2 2 3 3 3 3 2 2 0 2 0 0 
0 0 2 0 0 2 2 2 2 2 2 0 0 2 0 0 
0 0 2 0 0 0 0 0 0 0 0 0 0 2 0 0 
0 0 2 5 5 5 5 5 5 5 5 5 5 2 0 0 
0 0 2 0 0 0 0 0 0 0 0 0 0 2 0 0 