16 16
800 300 2 2 16 16

16 16
0 0
80 1 0

16
255 255 255
3 3 3
192 129 62
241 192 133
224 168 97
136 95 51
74 74 74
157 24 24
52 34 20
132 132 132
230 34 34
217 217 217
76 46 25
113 70 39

0 0 0
0 0 0

1
256
0 0 0 0 0 0 0 0 0 0 0 0 0 0 0 0 
0 0 1 1 1 1 0 0 0 1 1 1 1 0 0 0 
0 1 2 3 3 3 1 0 1 3 3 3 2 1 0 0 
0 1 2 4 5 5 2 1 2 5 2 4 2 1 1 0 
1 6 2 4 4 4 4 7 4 4 4 4 2 6 1 0 
1 8 2 4 5 2 5 7 5 2 5 4 2 8 1 0 
1 8 2 4 4 4 4 7 4 4 4 4 2 8 1 0 
1 8 2 4 5 5 2 7 2 5 5 4 2 8 1 0 
1 8 2 4 4 4 4 7 4 4 4 4 2 8 1 0 
1 8 2 4 2 5 5 7 2 5 5 4 2 8 1 0 
1 8 2 4 4 4 4 7 4 4 4 4 2 8 1 0 
1 9 5 2 5 5 5 10 5 5 5 2 5 9 1 0 
1 11 6 12 12 12 8 10 8 12 12 8 6 11 1 0 
0 1 1 1 1 1 13 10 13 1 1 1 1 1 0 0 
0 0 0 0 0 0 1 1 1 0 0 0 0 0 0 0 
0 0 0 0 0 0 0 0 0 0 0 0 0 0 0 0