16 16
800 300 2 2 16 16

16 16
0 0
80 1 0

16
220 220 220
8 8 8
76 46 25
155 103 66
169 181 255
179 179 179
108 126 233
245 83 186
222 36 155
157 36 113

0 0 0
0 0 0
0 0 0
0 0 0
0 0 0
0 0 0

1
256
0 0 0 0 0 1 1 1 1 1 1 0 0 0 0 0 
0 0 0 0 0 1 2 3 3 2 1 0 0 0 0 0 
0 0 0 0 1 1 2 3 3 2 1 1 0 0 0 0 
0 0 0 0 1 4 5 0 0 5 4 1 0 0 0 0 
0 0 0 0 1 4 6 4 4 6 4 1 0 0 0 0 
0 0 0 0 1 1 4 0 0 4 1 1 0 0 0 0 
0 0 0 0 0 1 4 0 0 4 1 0 0 0 0 0 
0 0 0 0 0 1 4 0 0 4 1 0 0 0 0 0 
0 0 0 0 1 4 4 7 7 4 4 1 0 0 0 0 
0 0 0 1 4 4 7 7 7 8 4 4 1 0 0 0 
0 0 1 6 4 8 8 8 8 8 9 4 6 1 0 0 
0 0 1 6 8 8 8 9 9 9 9 9 6 1 0 0 
0 0 1 6 9 9 9 9 9 9 9 9 6 1 0 0 
0 0 1 6 9 9 9 9 9 9 9 9 6 1 0 0 
0 0 1 6 6 6 6 6 6 6 6 6 6 1 0 0 
0 0 0 1 1 1 1 1 1 1 1 1 1 0 0 0 