16 16
800 300 2 2 16 16

16 16
0 0
80 1 0

16
255 255 255
230 200 230
219 176 219
201 187 2
227 211 0
130 0 130
155 36 155
179 19 179
112 0 112
233 114 233
88 0 88
186 173 0

0 0 0
0 0 0
0 0 0
0 0 0

1
256
0 0 0 0 0 1 2 3 4 2 1 0 0 0 0 0 
0 0 0 1 2 2 5 5 5 5 2 2 1 0 0 0 
0 0 4 2 5 5 5 6 6 6 6 5 2 0 1 0 
0 4 2 2 5 5 6 6 7 7 6 6 2 2 0 0 
0 4 2 8 8 5 6 7 7 9 7 5 5 2 0 0 
0 4 2 8 10 8 5 6 7 7 7 6 5 2 1 0 
0 4 1 8 10 8 5 5 6 6 5 5 8 2 1 0 
0 4 2 8 10 10 8 5 5 5 8 8 8 2 0 0 
0 4 2 2 8 10 10 8 8 8 10 8 2 2 1 0 
0 4 4 2 8 8 10 10 10 10 8 8 2 0 0 0 
0 0 4 0 2 2 8 8 8 8 2 2 2 0 1 0 
0 0 3 4 0 1 0 11 11 0 2 0 0 0 0 0 
0 0 0 3 3 3 3 3 4 1 0 0 1 0 0 0 
0 0 0 0 0 0 0 3 4 0 0 0 0 0 0 0 
0 0 0 0 0 0 0 3 4 0 0 0 0 0 0 0 
0 0 0 0 4 3 3 4 4 4 4 4 0 0 0 0