16 16
800 300 2 2 16 16

16 16
0 0
80 1 0

16
65 0 65
103 2 154
130 0 195
117 2 118
145 0 217
243 243 243
218 218 218
86 1 87
255 255 255

0 0 0
0 0 0
0 0 0
0 0 0
0 0 0
0 0 0
0 0 0

1
256
0 0 0 0 0 0 0 0 0 0 0 0 0 0 0 0 
0 1 1 2 0 2 3 3 3 3 4 0 4 4 4 0 
0 1 1 0 2 2 2 3 3 4 2 4 0 4 4 0 
0 1 0 0 2 2 2 0 0 4 2 2 0 0 4 0 
0 0 1 2 5 2 2 6 5 4 2 5 2 4 0 0 
0 1 1 2 2 5 2 6 5 4 5 2 2 2 4 0 
0 7 1 2 2 2 6 6 5 5 4 4 4 4 3 0 
0 7 7 0 5 5 5 0 0 5 5 5 0 3 3 0 
0 7 7 0 6 6 6 0 0 6 6 6 0 3 3 0 
0 7 1 2 2 2 6 6 5 5 2 2 2 2 3 0 
0 1 1 1 2 6 2 6 5 2 5 2 2 2 2 0 
8 0 1 1 6 2 2 6 5 2 2 5 2 2 0 8 
8 8 0 0 1 1 2 0 0 2 2 2 0 0 8 8 
8 8 8 0 1 1 1 3 3 2 2 2 0 8 8 8 
8 8 8 8 0 1 7 7 7 3 2 0 8 8 8 8 
8 8 8 8 8 0 0 0 0 0 0 8 8 8 8 8 