16 16
800 300 2 2 16 16

16 16
0 0
80 1 0

16
255 255 255
0 116 0
0 140 0
0 97 0
0 164 0
113 88 0
84 66 1

0 0 0
0 0 0
0 0 0
0 0 0
0 0 0
0 0 0
0 0 0
0 0 0
0 0 0

1
256
0 0 0 0 0 0 1 1 2 2 0 0 0 0 0 0 
0 0 0 3 0 3 2 2 4 4 2 0 0 0 0 0 
0 0 0 0 3 1 2 4 4 4 2 1 0 2 0 0 
0 0 0 3 3 1 2 4 4 4 2 2 2 0 0 0 
0 0 0 3 1 2 2 2 4 4 4 4 2 1 0 0 
0 0 3 3 3 1 1 2 5 4 4 4 2 0 0 0 
0 0 3 3 3 3 1 2 2 2 4 2 2 1 0 0 
0 3 3 3 3 1 3 2 1 2 2 2 1 3 0 0 
0 0 1 3 3 3 2 3 5 3 1 2 2 1 3 0 
0 0 0 1 3 3 3 5 5 2 3 3 1 3 0 0 
0 0 1 1 3 3 3 3 1 3 1 3 3 0 0 0 
0 0 0 0 1 1 3 3 3 3 1 0 0 0 0 0 
0 0 0 0 0 0 1 1 1 1 0 0 0 0 0 0 
0 0 0 0 0 0 0 6 6 0 0 0 0 0 0 0 
0 0 0 0 0 0 0 5 5 0 0 0 0 0 0 0 
0 0 0 0 0 0 0 5 5 0 0 0 0 0 0 0 