16 16
0 0
80 1 0

16
255 255 255
130 65 48
201 65 30
130 130 130
97 146 0
195 195 32
0 81 81
0 0 146
48 0 81
105 54 41

0 0 0
0 0 0
0 0 0
0 0 0
0 0 0
0 0 0

1
256
0 0 1 1 1 1 1 1 1 1 1 1 1 1 0 0 
0 0 1 2 0 3 4 5 6 0 7 0 8 1 0 0 
0 0 1 2 6 3 4 5 6 4 7 5 8 1 0 0 
0 0 1 2 6 3 4 5 6 4 7 5 8 1 0 0 
0 0 1 1 1 1 1 1 1 1 1 1 1 1 0 0 
0 0 1 0 7 0 8 5 3 0 0 2 0 1 0 0 
0 0 1 3 7 2 8 5 3 5 7 2 4 1 0 0 
0 0 1 3 7 2 8 5 3 5 7 2 4 1 0 0 
0 0 1 1 1 1 1 1 1 1 1 1 1 1 0 0 
0 0 1 0 0 5 7 0 4 3 5 6 0 1 0 0 
0 0 1 8 4 5 7 2 4 3 5 6 7 1 0 0 
0 0 1 8 4 5 7 2 4 3 5 6 7 1 0 0 
0 0 1 1 1 1 1 1 1 1 1 1 1 1 0 0 
0 0 1 9 9 9 9 9 9 9 9 9 9 1 0 0 
0 0 1 9 9 9 9 9 9 9 9 9 9 1 0 0 
0 0 1 0 0 0 0 0 0 0 0 0 0 1 0 0 