16 16
0 0
80 1 0

16
255 255 255
199 158 20
142 110 0
101 0 0
130 1 1
106 85 11
81 0 0

0 0 0
0 0 0
0 0 0
0 0 0
0 0 0
0 0 0
0 0 0
0 0 0
0 0 0

1
256
0 0 0 0 0 1 0 0 0 0 0 0 0 0 0 0 
0 0 0 0 1 2 0 0 0 0 0 0 0 0 0 0 
0 0 0 1 3 2 0 0 0 0 0 0 0 0 0 0 
0 0 0 2 3 2 0 0 0 0 0 0 0 0 0 0 
0 0 0 2 3 2 0 0 0 0 0 0 0 0 0 0 
0 0 0 2 0 2 0 0 0 0 0 0 0 0 0 0 
0 0 0 2 0 2 0 0 0 0 0 0 0 0 0 0 
0 0 0 2 0 4 4 4 4 4 4 3 0 0 0 0 
0 0 0 2 4 4 4 4 4 4 3 5 0 0 0 0 
0 0 0 2 6 6 6 6 6 3 0 5 0 0 0 0 
0 0 0 2 0 5 0 0 0 2 0 2 0 0 0 0 
0 0 0 2 0 5 0 0 0 2 0 2 0 0 0 0 
0 0 0 2 0 2 0 0 0 2 0 2 0 0 0 0 
0 0 0 2 0 2 0 0 0 2 0 2 0 0 0 0 
0 0 0 2 0 0 0 0 0 2 0 0 0 0 0 0 
0 0 0 2 0 0 0 0 0 2 0 0 0 0 0 0 