8 8
6 4
20 1 0

16
255 255 255
255 255 255
204 150 63
205 134 29
205 184 154
68 65 60
191 140 59
237 171 73

0 0 0
0 0 0
0 0 0
0 0 0
0 0 0
0 0 0
0 0 0
0 0 0

1
320
0 0 0 0 0 0 0 0 
0 0 2 0 0 0 0 0 
0 3 2 4 0 0 0 0 
5 3 3 4 2 0 0 4 
0 0 4 2 3 3 3 3 
0 0 6 7 7 7 7 7 
0 0 0 7 0 0 1 7 
0 0 4 0 0 0 1 4 

0 0 0 0 0 0 0 0 
0 0 2 0 0 0 0 0 
0 3 2 4 0 0 0 0 
5 3 3 4 2 0 0 4 
0 0 4 2 3 3 3 3 
0 0 6 7 7 7 7 7 
0 0 0 7 0 0 1 7 
0 0 4 0 0 0 1 4 

1 1 1 1 1 1 1 1 
0 0 0 0 0 0 0 0 
0 0 2 0 0 0 0 0 
0 3 2 4 0 0 0 0 
5 3 3 4 2 0 0 4 
0 0 4 2 3 3 3 3 
0 0 6 7 7 7 7 7 
0 4 1 0 0 0 1 4 

0 0 0 0 0 0 0 0 
0 0 0 0 0 0 0 0 
1 1 1 1 1 1 1 1 
0 0 0 2 0 0 0 0 
0 3 2 4 0 0 0 0 
5 3 3 4 2 0 0 4 
0 0 4 2 3 3 3 3 
4 3 6 7 7 7 7 4 

0 0 0 0 0 0 0 0 
0 0 0 0 0 0 0 0 
1 1 1 1 1 1 1 1 
0 0 0 2 0 0 0 0 
0 3 2 4 0 0 0 0 
5 3 3 4 2 0 0 0 
0 0 4 2 3 3 3 4 
4 3 6 7 7 7 7 4 

0 0 0 0 0 0 0 0 
0 0 0 0 0 0 0 0 
1 1 1 1 1 1 1 1 
0 0 0 2 0 0 0 0 
0 3 2 4 0 0 0 0 
5 3 3 4 2 0 0 4 
0 0 4 2 3 3 3 3 
4 3 6 7 7 7 7 4 

0 0 0 0 0 0 0 0 
0 0 0 0 0 0 0 0 
1 1 1 1 1 1 1 1 
0 0 0 2 0 0 0 0 
0 3 2 4 0 0 0 0 
5 3 3 4 2 0 0 0 
0 0 4 2 3 3 3 3 
4 3 6 7 7 7 7 4 

0 0 0 0 0 0 0 0 
0 0 0 0 0 0 0 0 
1 1 1 1 1 1 1 1 
0 0 0 2 0 0 0 0 
0 3 2 4 0 0 0 0 
5 3 3 4 2 0 0 4 
0 0 4 2 3 3 3 3 
4 3 6 7 7 7 7 4 

0 0 0 0 0 0 0 0 
0 0 0 0 0 0 0 0 
1 1 1 1 1 1 1 1 
0 0 0 2 0 0 0 0 
0 3 2 4 0 0 0 0 
5 3 3 4 2 0 0 0 
0 0 4 2 3 3 3 4 
4 3 6 7 7 7 7 4