16 16
0 0
40 1 0

16
255 255 255
42 39 89
49 57 119
33 22 46
20 13 43
51 79 136
56 109 155
67 148 176
70 31 69
113 42 74
171 50 70
220 88 74
246 129 80

0 0 0
0 0 0
0 0 0

1
2048
0 0 0 0 0 0 0 0 0 0 0 0 0 0 0 0 
0 0 0 0 0 0 0 0 0 0 0 0 0 0 0 0 
0 0 0 0 0 0 0 0 0 0 0 0 0 0 0 0 
0 0 0 0 0 0 0 0 0 0 0 0 0 0 0 0 
0 0 0 0 0 0 0 0 0 0 0 0 0 0 0 0 
0 0 0 0 0 1 1 1 1 1 1 0 0 0 0 0 
0 0 0 0 1 1 2 2 2 2 1 1 0 0 0 0 
0 0 0 1 1 2 2 1 1 2 2 1 1 0 0 0 
0 0 0 1 2 2 1 2 2 1 2 2 1 0 0 0 
0 0 0 1 2 2 1 2 2 1 2 2 1 0 0 0 
0 0 0 1 2 2 1 2 2 1 2 2 1 0 0 0 
0 0 0 1 2 2 1 2 2 1 2 2 1 0 0 0 
0 0 3 3 3 3 3 3 3 3 3 3 3 3 0 0 
0 3 3 3 3 3 3 3 3 3 3 3 3 3 3 0 
4 4 4 4 4 4 4 4 4 4 4 4 4 4 4 4 
4 4 4 4 4 4 4 4 4 4 4 4 4 4 4 4 

0 0 0 0 0 0 0 0 0 0 0 0 0 0 0 0 
0 0 0 0 0 0 0 0 0 0 0 0 0 0 0 0 
0 0 0 0 0 0 0 0 0 0 0 0 0 0 0 0 
0 0 0 0 0 0 0 0 0 0 0 0 0 0 0 0 
0 0 0 0 0 0 0 0 0 0 0 0 0 0 0 0 
0 0 0 0 0 1 1 1 1 1 1 0 0 0 0 0 
0 0 0 0 1 1 2 5 5 2 1 1 0 0 0 0 
0 0 0 1 1 2 5 2 2 5 2 1 1 0 0 0 
0 0 0 1 2 2 1 5 5 1 2 2 1 0 0 0 
0 0 0 1 2 2 1 2 2 1 2 2 1 0 0 0 
0 0 0 1 2 2 1 2 2 1 2 2 1 0 0 0 
0 0 0 1 2 2 1 2 2 1 2 2 1 0 0 0 
0 0 3 3 3 3 3 3 3 3 3 3 3 3 0 0 
0 3 3 3 3 3 3 3 3 3 3 3 3 3 3 0 
4 4 4 4 4 4 4 4 4 4 4 4 4 4 4 4 
4 4 4 4 4 4 4 4 4 4 4 4 4 4 4 4 

0 0 0 0 0 0 0 0 0 0 0 0 0 0 0 0 
0 0 0 0 0 0 0 0 0 0 0 0 0 0 0 0 
0 0 0 0 0 0 0 0 0 0 0 0 0 0 0 0 
0 0 0 0 0 0 0 0 0 0 0 0 0 0 0 0 
0 0 0 0 0 0 0 0 0 0 0 0 0 0 0 0 
0 0 0 0 0 2 2 2 2 2 2 0 0 0 0 0 
0 0 0 0 2 2 5 6 6 5 2 2 0 0 0 0 
0 0 0 2 2 5 6 6 6 6 5 2 2 0 0 0 
0 0 0 2 5 5 2 6 6 2 5 5 2 0 0 0 
0 0 0 2 5 5 2 5 5 2 5 5 2 0 0 0 
0 0 0 2 5 5 2 5 5 2 5 5 2 0 0 0 
0 0 0 2 5 5 2 5 5 2 5 5 2 0 0 0 
0 0 3 1 1 1 1 1 1 1 1 1 1 3 0 0 
0 3 3 3 3 3 3 3 3 3 3 3 3 3 3 0 
4 4 4 4 4 4 4 4 4 4 4 4 4 4 4 4 
4 4 4 4 4 4 4 4 4 4 4 4 4 4 4 4 

0 0 0 0 0 0 0 0 0 0 0 0 0 0 0 0 
0 0 0 0 0 0 0 0 0 0 0 0 0 0 0 0 
0 0 0 0 0 0 0 0 0 0 0 0 0 0 0 0 
0 0 0 0 0 0 0 0 0 0 0 0 0 0 0 0 
0 0 0 0 0 0 0 0 0 0 0 0 0 0 0 0 
0 0 0 0 0 5 5 5 5 5 5 0 0 0 0 0 
0 0 0 0 5 5 6 7 7 6 5 5 0 0 0 0 
0 0 0 5 5 6 7 7 7 7 6 5 5 0 0 0 
0 0 0 5 6 6 6 7 7 6 6 6 5 0 0 0 
0 0 0 5 6 6 6 6 6 6 6 6 5 0 0 0 
0 0 0 5 6 6 6 6 6 6 6 6 5 0 0 0 
0 0 0 5 6 6 6 6 6 6 6 6 5 0 0 0 
0 0 1 2 2 2 2 2 2 2 2 2 2 1 0 0 
0 3 3 1 1 1 1 1 1 1 1 1 1 3 3 0 
4 4 4 4 4 4 4 4 4 4 4 4 4 4 4 4 
4 4 4 4 4 4 4 4 4 4 4 4 4 4 4 4 

0 0 0 0 0 0 0 0 0 0 0 0 0 0 0 0 
0 0 0 0 0 0 0 0 0 0 0 0 0 0 0 0 
0 0 0 0 0 0 0 0 0 0 0 0 0 0 0 0 
0 0 0 0 0 0 0 0 0 0 0 0 0 0 0 0 
0 0 0 0 0 0 0 0 0 0 0 0 0 0 0 0 
0 0 0 0 0 8 8 8 8 8 8 0 0 0 0 0 
0 0 0 0 8 8 9 9 9 9 8 8 0 0 0 0 
0 0 0 8 8 9 9 8 8 9 9 8 8 0 0 0 
0 0 0 8 9 9 8 9 9 8 9 9 8 0 0 0 
0 0 0 8 9 9 8 9 9 8 9 9 8 0 0 0 
0 0 0 8 9 9 8 9 9 8 9 9 8 0 0 0 
0 0 0 8 9 9 8 9 9 8 9 9 8 0 0 0 
0 0 3 3 3 3 3 3 3 3 3 3 3 3 0 0 
0 3 3 3 3 3 3 3 3 3 3 3 3 3 3 0 
4 4 4 4 4 4 4 4 4 4 4 4 4 4 4 4 
4 4 4 4 4 4 4 4 4 4 4 4 4 4 4 4 

0 0 0 0 0 0 0 0 0 0 0 0 0 0 0 0 
0 0 0 0 0 0 0 0 0 0 0 0 0 0 0 0 
0 0 0 0 0 0 0 0 0 0 0 0 0 0 0 0 
0 0 0 0 0 0 0 0 0 0 0 0 0 0 0 0 
0 0 0 0 0 0 0 0 0 0 0 0 0 0 0 0 
0 0 0 0 0 8 8 8 8 8 8 0 0 0 0 0 
0 0 0 0 8 8 9 10 10 9 8 8 0 0 0 0 
0 0 0 8 8 9 10 9 9 10 9 8 8 0 0 0 
0 0 0 8 9 9 8 10 10 8 9 9 8 0 0 0 
0 0 0 8 9 9 8 9 9 8 9 9 8 0 0 0 
0 0 0 8 9 9 8 9 9 8 9 9 8 0 0 0 
0 0 0 8 9 9 8 9 9 8 9 9 8 0 0 0 
0 0 3 3 3 3 3 3 3 3 3 3 3 3 0 0 
0 3 3 3 3 3 3 3 3 3 3 3 3 3 3 0 
4 4 4 4 4 4 4 4 4 4 4 4 4 4 4 4 
4 4 4 4 4 4 4 4 4 4 4 4 4 4 4 4 

0 0 0 0 0 0 0 0 0 0 0 0 0 0 0 0 
0 0 0 0 0 0 0 0 0 0 0 0 0 0 0 0 
0 0 0 0 0 0 0 0 0 0 0 0 0 0 0 0 
0 0 0 0 0 0 0 0 0 0 0 0 0 0 0 0 
0 0 0 0 0 0 0 0 0 0 0 0 0 0 0 0 
0 0 0 0 0 9 9 9 9 9 9 0 0 0 0 0 
0 0 0 0 9 9 10 11 11 10 9 9 0 0 0 0 
0 0 0 9 9 10 11 11 11 11 10 9 9 0 0 0 
0 0 0 9 10 10 9 11 11 9 10 10 9 0 0 0 
0 0 0 9 10 10 9 10 10 9 10 10 9 0 0 0 
0 0 0 9 10 10 9 10 10 9 10 10 9 0 0 0 
0 0 0 9 10 10 9 10 10 9 10 10 9 0 0 0 
0 0 3 8 8 8 8 8 8 8 8 8 8 3 0 0 
0 3 3 3 3 3 3 3 3 3 3 3 3 3 3 0 
4 4 4 4 4 4 4 4 4 4 4 4 4 4 4 4 
4 4 4 4 4 4 4 4 4 4 4 4 4 4 4 4 

0 0 0 0 0 0 0 0 0 0 0 0 0 0 0 0 
0 0 0 0 0 0 0 0 0 0 0 0 0 0 0 0 
0 0 0 0 0 0 0 0 0 0 0 0 0 0 0 0 
0 0 0 0 0 0 0 0 0 0 0 0 0 0 0 0 
0 0 0 0 0 0 0 0 0 0 0 0 0 0 0 0 
0 0 0 0 0 10 10 10 10 10 10 0 0 0 0 0 
0 0 0 0 10 10 11 12 12 11 10 10 0 0 0 0 
0 0 0 10 10 11 12 12 12 12 11 10 10 0 0 0 
0 0 0 10 11 11 11 12 12 11 11 11 10 0 0 0 
0 0 0 10 11 11 11 11 11 11 11 11 10 0 0 0 
0 0 0 10 11 11 11 11 11 11 11 11 10 0 0 0 
0 0 0 10 11 11 11 11 11 11 11 11 10 0 0 0 
0 0 8 9 9 9 9 9 9 9 9 9 9 8 0 0 
0 3 3 8 8 8 8 8 8 8 8 8 8 3 3 0 
4 4 4 4 4 4 4 4 4 4 4 4 4 4 4 4 
4 4 4 4 4 4 4 4 4 4 4 4 4 4 4 4 