16 16
0 0
80 1 0

16
255 255 255
255 253 213
255 255 220
255 250 166
255 249 142
255 243 44
255 255 82

0 0 0
0 0 0
0 0 0
0 0 0
0 0 0
0 0 0
0 0 0
0 0 0
0 0 0

1
256
0 0 0 0 0 0 0 0 0 0 0 0 0 0 0 0 
0 0 0 0 0 1 1 1 1 1 2 0 0 0 0 0 
0 0 0 1 1 3 4 4 3 4 4 1 1 0 0 0 
0 0 1 1 4 4 5 5 5 5 4 3 1 1 0 0 
0 0 1 4 4 5 6 6 6 6 5 4 3 1 0 0 
0 1 4 4 5 6 6 6 6 6 6 5 4 3 1 0 
0 1 3 5 5 6 6 6 6 6 6 5 5 3 1 0 
0 1 4 5 6 6 6 6 6 6 6 6 5 4 1 0 
0 1 4 5 6 6 6 6 6 6 6 6 5 4 1 0 
0 1 3 5 6 6 6 6 6 6 6 5 5 3 1 0 
0 1 4 4 5 6 6 6 6 6 6 5 4 4 1 0 
0 0 1 3 4 5 6 6 6 6 5 4 3 1 0 0 
0 0 1 1 3 4 5 5 5 5 4 3 1 1 0 0 
0 0 0 1 1 3 4 3 4 4 3 1 1 0 0 0 
0 0 0 0 0 1 1 1 1 1 1 0 0 0 0 0 
0 0 0 0 0 0 0 0 0 0 0 0 0 0 0 0 