16 16
0 0
80 1 0

11
255 255 255
183 144 11
142 110 0
190 216 216
149 163 163
211 243 243
0 146 146
135 105 2
106 85 11
167 194 194
0 113 113

1
256
0 0 0 0 0 0 0 0 0 0 0 0 0 0 0 0 
0 0 1 0 0 0 0 0 0 0 0 0 0 0 0 0 
0 1 2 0 0 0 0 0 0 0 0 0 0 0 0 1 
1 0 2 0 0 0 0 0 0 0 0 0 0 0 1 2 
2 0 2 3 0 0 0 0 0 0 0 0 0 1 0 2 
2 0 3 3 3 0 0 0 0 0 0 0 0 2 0 2 
2 4 3 3 3 3 5 6 6 6 6 6 6 2 6 2 
2 7 4 3 3 5 6 6 6 6 6 6 6 2 1 2 
2 5 5 4 5 6 6 6 6 6 6 6 6 2 8 2 
2 9 9 9 9 10 10 10 10 10 10 10 10 2 8 2 
2 9 9 9 9 10 10 10 10 10 10 10 10 2 0 2 
2 9 9 9 9 10 10 10 10 10 10 10 10 2 0 8 
2 0 8 0 0 10 10 10 10 10 10 10 10 2 0 8 
2 0 8 0 0 0 0 0 0 0 0 0 0 2 0 8 
2 0 0 0 0 0 0 0 0 0 0 0 0 2 0 0 
2 0 0 0 0 0 0 0 0 0 0 0 0 2 0 0