16 16
0 0
8 1 0

6
255 255 255
35 54 99
99 194 201
31 24 51
76 147 173
184 253 255

1
2048
0 0 0 0 0 0 0 0 0 0 0 0 0 0 0 0 
0 0 0 1 1 0 0 0 0 0 0 0 0 0 0 0 
0 0 0 1 2 1 0 0 0 0 0 0 0 0 0 0 
0 0 0 0 3 4 1 0 0 0 0 0 0 0 0 0 
0 0 0 0 3 2 4 1 1 1 1 1 0 0 0 0 
0 0 0 3 4 2 2 2 2 2 2 4 1 0 0 0 
0 0 0 3 2 2 5 5 5 5 5 2 1 0 0 0 
0 0 0 3 4 5 0 1 0 0 1 5 1 0 0 0 
0 0 0 3 2 5 0 1 0 0 1 5 1 0 0 0 
0 0 0 3 4 5 5 3 5 5 3 5 1 0 0 0 
0 0 0 3 2 2 5 5 5 5 5 2 1 0 0 0 
0 0 0 3 4 2 2 2 2 2 2 2 3 0 0 0 
0 0 0 3 4 4 2 2 2 2 2 4 3 0 0 0 
0 0 0 3 4 4 4 3 3 3 3 3 0 0 0 0 
0 0 0 3 4 4 3 0 0 0 0 0 0 0 0 0 
0 0 0 0 3 3 0 0 0 0 0 0 0 0 0 0 

0 0 0 0 0 0 0 0 0 0 0 0 0 0 0 0 
0 0 0 0 0 0 0 0 0 0 0 0 0 0 0 0 
0 0 0 1 1 1 0 0 0 0 0 0 0 0 0 0 
0 0 0 1 2 4 1 0 0 0 0 0 0 0 0 0 
0 0 0 0 3 2 4 1 1 1 1 1 0 0 0 0 
0 0 0 3 4 2 2 2 2 2 2 4 1 0 0 0 
0 0 0 3 2 2 5 5 5 5 5 2 1 0 0 0 
0 0 0 3 4 5 0 1 0 0 1 5 1 0 0 0 
0 0 0 3 2 5 0 1 0 0 1 5 1 0 0 0 
0 0 0 3 4 5 5 3 5 5 3 5 1 0 0 0 
0 0 0 3 2 2 5 5 5 5 5 2 1 0 0 0 
0 0 0 3 4 2 2 2 2 2 2 2 1 0 0 0 
0 0 0 3 4 4 2 2 2 2 2 4 3 0 0 0 
0 0 3 4 4 4 3 3 3 4 4 4 3 0 0 0 
0 0 3 4 4 3 0 0 0 3 3 3 0 0 0 0 
0 0 0 3 3 0 0 0 0 0 0 0 0 0 0 0 

0 0 0 0 0 0 0 0 0 0 0 0 0 0 0 0 
0 0 0 0 0 0 0 0 0 0 0 0 0 0 0 0 
0 0 0 1 1 1 1 0 0 0 0 0 0 0 0 0 
0 0 0 1 4 2 4 1 1 1 1 1 0 0 0 0 
0 0 0 0 3 2 2 2 2 2 2 4 1 0 0 0 
0 0 0 3 4 2 5 5 5 5 5 2 1 0 0 0 
0 0 0 3 2 5 0 1 0 0 1 5 1 0 0 0 
0 0 0 3 4 5 0 1 0 0 1 5 1 0 0 0 
0 0 0 3 2 5 5 3 5 5 3 5 1 0 0 0 
0 0 0 3 4 2 5 5 5 5 5 2 1 0 0 0 
0 0 0 3 2 2 2 2 2 2 2 2 1 0 0 0 
0 0 0 3 4 2 2 2 2 2 2 2 1 0 0 0 
0 0 3 4 4 4 2 2 2 2 2 2 4 3 0 0 
0 0 3 4 4 4 4 3 3 3 3 4 4 3 0 0 
0 0 0 3 3 3 3 0 0 0 0 3 3 0 0 0 
0 0 0 0 0 0 0 0 0 0 0 0 0 0 0 0 

0 0 0 0 0 0 0 0 0 0 0 0 0 0 0 0 
0 0 0 1 1 1 0 0 0 0 0 0 0 0 0 0 
0 0 0 1 2 4 1 0 0 0 0 0 0 0 0 0 
0 0 0 0 3 2 4 1 1 1 1 1 0 0 0 0 
0 0 0 3 4 2 2 2 2 2 2 4 1 0 0 0 
0 0 0 3 2 2 5 5 5 5 5 2 1 0 0 0 
0 0 0 3 4 5 0 1 0 0 1 5 1 0 0 0 
0 0 0 3 2 5 0 1 0 0 1 5 1 0 0 0 
0 0 0 3 4 5 5 3 5 5 3 5 1 0 0 0 
0 0 0 3 2 2 5 5 5 5 5 2 1 0 0 0 
0 0 0 3 4 2 2 2 2 2 2 2 1 0 0 0 
0 0 0 3 3 2 2 2 2 2 2 2 1 0 0 0 
0 0 0 3 4 4 2 2 2 2 2 4 3 0 0 0 
0 0 0 3 4 4 4 3 3 3 4 4 4 3 0 0 
0 0 0 0 3 3 3 0 0 0 3 4 4 3 0 0 
0 0 0 0 0 0 0 0 0 0 0 3 3 0 0 0 

0 0 0 0 0 0 0 0 0 0 0 0 0 0 0 0 
0 0 0 1 1 0 0 0 0 0 0 0 0 0 0 0 
0 0 0 1 2 1 0 0 0 0 0 0 0 0 0 0 
0 0 0 0 3 4 1 0 0 0 0 0 0 0 0 0 
0 0 0 0 3 2 4 1 1 1 1 1 0 0 0 0 
0 0 0 3 4 2 2 2 2 2 2 4 1 0 0 0 
0 0 0 3 2 2 5 5 5 5 5 2 1 0 0 0 
0 0 0 3 4 5 0 1 0 0 1 5 1 0 0 0 
0 0 0 3 2 5 0 1 0 0 1 5 1 0 0 0 
0 0 0 3 4 5 5 3 5 5 3 5 1 0 0 0 
0 0 0 3 2 2 5 5 5 5 5 2 1 0 0 0 
0 0 0 3 4 2 2 2 2 2 2 2 1 0 0 0 
0 0 0 3 4 4 2 4 1 2 2 4 3 0 0 0 
0 0 0 3 4 4 4 3 3 4 4 4 3 0 0 0 
0 0 0 0 3 3 3 0 0 3 4 4 3 0 0 0 
0 0 0 0 0 0 0 0 0 0 3 3 0 0 0 0 

0 0 0 0 0 0 0 0 0 0 0 0 0 0 0 0 
0 0 0 0 0 0 0 0 0 0 0 0 0 0 0 0 
0 0 0 1 1 1 0 0 0 0 0 0 0 0 0 0 
0 0 0 1 2 4 1 0 0 0 0 0 0 0 0 0 
0 0 0 0 3 2 4 1 1 1 1 1 0 0 0 0 
0 0 0 3 4 2 2 2 2 2 2 4 1 0 0 0 
0 0 0 3 2 2 5 5 5 5 5 2 1 0 0 0 
0 0 0 3 4 5 0 1 0 0 1 5 1 0 0 0 
0 0 0 3 2 5 0 1 0 0 1 5 1 0 0 0 
0 0 0 3 4 5 5 3 5 5 3 5 1 0 0 0 
0 0 0 3 2 2 5 5 5 5 5 2 1 0 0 0 
0 0 0 3 4 2 2 1 2 2 2 2 1 0 0 0 
0 0 0 3 4 4 2 4 1 2 2 4 3 0 0 0 
0 0 0 0 3 4 4 4 3 4 4 4 3 0 0 0 
0 0 0 0 0 3 3 3 3 4 4 3 0 0 0 0 
0 0 0 0 0 0 0 0 0 3 3 0 0 0 0 0 

0 0 0 0 0 0 0 0 0 0 0 0 0 0 0 0 
0 0 0 0 0 0 0 0 0 0 0 0 0 0 0 0 
0 0 0 1 1 1 1 0 0 0 0 0 0 0 0 0 
0 0 0 1 4 2 4 1 1 1 1 1 0 0 0 0 
0 0 0 0 3 2 2 2 2 2 2 4 1 0 0 0 
0 0 0 3 4 2 5 5 5 5 5 2 1 0 0 0 
0 0 0 3 2 5 0 1 0 0 1 5 1 0 0 0 
0 0 0 3 4 5 0 1 0 0 1 5 1 0 0 0 
0 0 0 3 2 5 5 3 5 5 3 5 1 0 0 0 
0 0 0 3 4 2 5 5 5 5 5 2 1 0 0 0 
0 0 0 3 2 2 2 2 2 2 2 2 1 0 0 0 
0 0 0 3 4 2 2 2 2 2 2 2 1 0 0 0 
0 0 0 3 2 2 2 2 1 2 2 4 3 0 0 0 
0 0 0 3 4 2 2 2 3 4 4 3 0 0 0 0 
0 0 0 0 3 4 4 4 3 3 3 0 0 0 0 0 
0 0 0 0 0 3 3 3 0 0 0 0 0 0 0 0 

0 0 0 0 0 0 0 0 0 0 0 0 0 0 0 0 
0 0 0 1 1 1 0 0 0 0 0 0 0 0 0 0 
0 0 0 1 2 4 1 0 0 0 0 0 0 0 0 0 
0 0 0 0 3 2 4 1 1 1 1 1 0 0 0 0 
0 0 0 3 4 2 2 2 2 2 2 4 1 0 0 0 
0 0 0 3 2 2 5 5 5 5 5 2 1 0 0 0 
0 0 0 3 4 5 0 1 0 0 1 5 1 0 0 0 
0 0 0 3 2 5 0 1 0 0 1 5 1 0 0 0 
0 0 0 3 4 5 5 3 5 5 3 5 1 0 0 0 
0 0 0 3 2 2 5 5 5 5 5 2 1 0 0 0 
0 0 0 3 4 2 2 2 2 2 2 2 1 0 0 0 
0 0 0 3 2 2 2 2 2 2 2 2 1 0 0 0 
0 0 0 3 4 2 2 2 2 2 2 4 3 0 0 0 
0 0 0 3 4 4 2 4 3 4 4 3 0 0 0 0 
0 0 0 0 3 4 4 3 0 3 3 0 0 0 0 0 
0 0 0 0 0 3 3 0 0 0 0 0 0 0 0 0 