16 16
0 0
80 1 0

16
255 255 255
243 32 32
243 162 81
243 243 0
113 88 0
139 108 2

0 0 0
0 0 0
0 0 0
0 0 0
0 0 0
0 0 0
0 0 0
0 0 0
0 0 0
0 0 0

1
256
0 0 0 0 0 0 0 0 1 0 0 0 0 0 0 0 
0 0 0 0 0 0 0 0 1 0 0 0 0 0 0 0 
0 0 0 0 0 0 0 1 1 0 0 0 0 0 0 0 
0 0 0 0 0 1 0 1 2 1 0 0 0 0 0 0 
0 0 0 0 0 1 0 1 3 1 0 0 1 0 0 0 
0 0 0 0 0 1 1 2 3 1 0 1 1 0 0 0 
0 0 0 1 0 1 2 2 3 2 1 1 1 0 0 0 
0 0 0 1 1 2 3 3 3 2 2 2 1 0 0 0 
0 0 0 0 1 3 2 3 3 2 3 2 1 0 0 0 
0 0 0 1 1 2 3 3 3 3 2 2 1 0 0 0 
0 0 0 0 1 1 2 3 3 3 2 1 0 0 0 0 
0 0 4 4 5 5 2 2 2 2 5 5 4 4 0 0 
0 0 0 0 0 4 5 4 0 5 5 4 0 0 0 0 
0 0 0 0 4 5 0 4 4 0 0 5 4 0 0 0 
0 0 0 4 5 0 0 0 0 4 0 0 0 0 0 0 
0 0 0 0 0 0 0 0 0 0 0 0 0 0 0 0 