16 16
0 0
10 1 0

16
8 8 8
255 136 17
255 204 17
255 255 255
119 119 136
119 68 17
221 0 85
153 102 102
68 68 85

0 0 0
0 0 0
0 0 0
0 0 0
0 0 0
0 0 0
0 0 0

1
2560
0 0 0 0 0 0 0 0 0 0 0 0 0 0 0 0 
0 0 0 0 0 0 0 0 0 0 0 0 0 0 0 0 
0 0 0 0 0 0 0 0 0 0 0 0 0 0 0 0 
0 0 0 0 0 0 0 0 0 0 0 0 0 0 0 0 
0 0 0 0 0 0 1 2 2 1 0 0 0 0 0 0 
0 0 0 0 0 2 3 3 3 3 2 0 0 0 0 0 
0 0 0 0 1 3 3 3 3 3 3 1 0 0 0 0 
0 0 0 0 2 3 3 3 3 3 3 2 0 0 0 0 
0 0 0 0 2 3 3 3 3 3 3 2 0 0 0 0 
0 0 0 0 1 3 3 3 3 3 3 1 0 0 0 0 
0 0 0 0 0 2 3 3 3 3 2 0 0 0 0 0 
0 0 0 0 0 0 1 2 2 1 0 0 0 0 0 0 
0 0 0 0 0 0 0 0 0 0 0 0 0 0 0 0 
0 0 0 0 0 0 0 0 0 0 0 0 0 0 0 0 
0 0 0 0 0 0 0 0 0 0 0 0 0 0 0 0 
0 0 0 0 0 0 0 0 0 0 0 0 0 0 0 0 

0 0 0 0 0 0 1 1 1 1 0 0 0 0 0 0 
0 0 0 0 1 1 2 2 2 2 1 1 0 0 0 0 
0 0 0 1 2 2 3 3 3 3 2 2 1 0 0 0 
0 0 1 2 3 3 3 3 3 3 3 3 2 1 0 0 
0 1 2 3 3 3 3 3 3 3 3 3 3 2 1 0 
0 1 2 3 3 3 3 3 3 3 3 3 3 2 1 0 
1 2 3 3 3 3 3 3 3 3 3 3 3 3 2 1 
1 2 3 3 3 3 3 3 3 3 3 3 3 3 2 1 
1 2 3 3 3 3 3 3 3 3 3 3 3 3 2 1 
1 2 3 3 3 3 3 3 3 3 3 3 3 3 2 1 
0 1 2 3 3 3 3 3 3 3 3 3 3 2 1 0 
0 1 2 3 3 3 3 3 3 3 3 3 3 2 1 0 
0 0 1 2 3 3 3 3 3 3 3 3 2 1 0 0 
0 0 0 1 2 2 3 3 3 3 2 2 1 0 0 0 
0 0 0 0 1 1 2 2 2 2 1 1 0 0 0 0 
0 0 0 0 0 0 1 1 1 1 0 0 0 0 0 0 

0 0 0 0 0 0 0 0 0 0 0 0 0 0 0 0 
0 0 0 0 0 0 0 4 4 4 0 0 0 0 0 0 
0 0 0 4 4 5 5 4 4 4 0 4 4 0 0 0 
0 0 4 4 4 4 5 1 1 1 5 4 4 4 0 0 
0 0 5 4 1 2 5 5 5 5 5 2 4 4 0 0 
0 0 5 5 2 5 5 6 6 6 6 5 1 4 0 0 
0 5 5 5 5 6 1 2 2 2 2 6 5 4 4 0 
0 5 4 2 5 6 1 3 3 3 2 6 5 2 4 0 
0 5 5 1 5 6 1 3 3 2 1 6 5 1 4 0 
0 0 5 5 5 5 6 2 2 1 6 5 5 5 5 0 
0 0 5 1 2 5 5 6 6 5 5 2 4 5 0 0 
0 0 5 4 1 1 5 5 5 5 1 1 4 5 0 0 
0 0 0 5 5 5 5 1 1 5 5 5 5 0 0 0 
0 0 0 0 0 0 5 5 5 5 0 0 0 0 0 0 
0 0 0 0 0 0 0 0 0 0 0 0 0 0 0 0 
0 0 0 0 0 0 0 0 0 0 0 0 0 0 0 0 

0 0 0 0 0 0 4 4 4 4 0 0 0 0 0 0 
0 0 4 4 0 5 4 4 4 4 4 0 0 0 0 0 
0 4 4 4 1 7 7 2 2 2 1 1 4 4 0 0 
0 5 4 1 2 7 7 7 7 7 7 2 4 4 4 0 
0 5 7 2 7 1 2 2 1 1 7 7 2 4 5 0 
0 1 7 7 1 2 3 3 3 3 1 7 7 1 5 0 
4 4 1 7 2 3 3 3 3 3 3 1 7 5 0 0 
4 4 2 7 2 3 3 3 3 3 3 2 7 1 4 4 
4 4 2 7 2 3 3 3 3 3 3 2 7 2 4 4 
0 1 1 7 1 3 3 3 3 3 3 2 7 2 1 5 
0 5 7 7 7 2 3 3 3 3 2 1 7 7 5 5 
0 5 4 2 7 7 1 2 2 2 1 7 2 4 5 0 
0 5 4 1 2 7 7 7 7 7 7 2 1 4 0 0 
0 0 5 4 5 5 1 2 2 1 5 4 4 5 0 0 
0 0 0 0 0 0 5 4 4 5 0 5 5 0 0 0 
0 0 0 0 0 0 0 0 0 0 0 0 0 0 0 0 

0 0 0 0 0 0 4 4 4 4 0 0 0 0 0 0 
0 0 4 4 4 5 4 4 4 4 4 0 4 4 0 0 
0 4 4 4 1 5 5 1 1 1 5 4 4 4 4 0 
0 5 4 1 5 5 5 5 5 5 5 4 1 4 4 0 
0 5 5 5 5 5 6 6 5 5 5 5 5 1 4 0 
0 5 5 5 5 6 1 1 1 6 5 5 5 5 5 0 
4 4 4 5 6 1 2 3 3 2 1 5 5 5 4 0 
4 1 4 5 6 2 3 3 3 3 2 6 5 1 4 4 
4 1 4 5 6 2 3 3 3 3 2 6 5 4 1 4 
5 4 4 5 5 1 2 3 3 3 2 6 5 4 1 4 
0 0 5 5 5 6 1 2 2 2 1 5 5 1 4 5 
0 5 1 5 5 5 5 6 6 6 5 5 5 0 0 0 
0 4 4 1 5 5 5 5 5 5 5 5 1 4 5 0 
0 5 4 4 1 5 1 1 1 1 5 1 4 4 5 0 
0 0 5 5 0 5 4 4 4 4 5 5 4 5 0 0 
0 0 0 0 0 0 0 5 5 5 0 0 0 0 0 0 

0 0 0 0 0 0 0 8 8 0 0 0 0 0 0 0 
0 0 4 8 0 0 4 4 4 4 0 8 8 0 0 0 
0 4 4 4 4 0 8 4 1 4 8 4 4 4 0 0 
0 8 4 1 4 8 8 8 8 8 8 8 4 4 4 0 
0 0 8 8 8 8 5 5 5 8 8 8 8 4 8 0 
0 0 8 8 5 5 6 6 6 5 5 8 8 8 0 0 
0 4 4 8 5 5 1 2 1 6 6 5 8 0 0 0 
0 4 1 8 5 6 2 3 3 2 1 5 5 4 4 0 
0 8 4 8 5 6 2 3 3 3 1 6 5 1 4 0 
0 8 8 8 5 6 1 2 2 2 1 6 5 8 8 0 
0 0 8 8 8 5 6 1 1 1 6 5 8 8 8 0 
0 8 4 4 8 8 5 5 6 6 5 8 8 0 0 0 
0 8 4 4 1 8 8 8 8 8 8 4 4 4 0 0 
0 0 8 8 8 8 4 1 1 4 8 8 4 8 0 0 
0 0 0 0 0 0 8 4 4 8 0 8 8 0 0 0 
0 0 0 0 0 0 0 0 0 0 0 0 0 0 0 0 

0 0 0 0 0 0 0 0 0 0 0 0 0 0 0 0 
0 0 0 0 0 0 0 0 0 0 0 0 0 0 0 0 
0 0 0 4 4 0 8 4 4 4 0 4 4 0 0 0 
0 0 8 4 4 8 8 4 4 8 0 4 4 8 0 0 
0 0 8 8 8 8 8 8 8 8 8 8 4 8 0 0 
0 0 0 0 8 8 5 5 5 5 8 8 8 0 0 0 
0 4 4 8 8 5 6 1 1 6 5 8 8 0 0 0 
0 8 4 4 8 5 1 2 3 1 6 5 4 4 0 0 
0 8 8 4 8 5 1 3 3 2 6 5 8 4 0 0 
0 0 8 8 8 5 6 1 2 1 5 8 8 8 0 0 
0 0 0 8 8 8 5 6 6 5 5 8 0 0 0 0 
0 0 8 4 4 8 8 8 5 5 8 4 4 0 0 0 
0 0 0 8 4 8 4 4 8 8 8 4 4 0 0 0 
0 0 0 0 0 0 8 4 4 0 8 8 8 0 0 0 
0 0 0 0 0 0 0 0 0 0 0 0 0 0 0 0 
0 0 0 0 0 0 0 0 0 0 0 0 0 0 0 0 

0 0 0 0 0 0 0 0 0 0 0 0 0 0 0 0 
0 0 0 0 0 0 0 0 0 0 0 0 0 0 0 0 
0 0 0 0 0 0 0 0 0 0 0 0 0 0 0 0 
0 0 0 0 4 4 0 4 0 0 4 4 0 0 0 0 
0 0 0 8 0 4 8 4 4 8 0 4 4 0 0 0 
0 0 0 8 8 8 8 0 8 8 8 4 8 0 0 0 
0 0 0 4 8 5 5 6 0 8 5 8 0 0 0 0 
0 0 4 0 4 0 0 1 2 6 0 4 8 0 0 0 
0 0 0 4 4 5 6 2 2 1 0 8 4 0 0 0 
0 0 0 8 8 5 0 6 1 6 5 8 8 0 0 0 
0 0 0 8 4 8 0 8 8 8 8 4 0 0 0 0 
0 0 0 0 8 4 4 0 8 8 0 4 0 0 0 0 
0 0 0 0 0 8 8 0 0 8 8 8 0 0 0 0 
0 0 0 0 0 0 0 0 0 0 0 0 0 0 0 0 
0 0 0 0 0 0 0 0 0 0 0 0 0 0 0 0 
0 0 0 0 0 0 0 0 0 0 0 0 0 0 0 0 

0 0 0 0 0 0 0 0 0 0 0 0 0 0 0 0 
0 0 0 0 0 0 0 0 0 0 0 0 0 0 0 0 
0 0 0 0 0 0 0 0 0 0 0 0 0 0 0 0 
0 0 0 0 0 4 0 4 0 0 8 0 0 0 0 0 
0 0 0 4 0 0 4 0 4 8 0 4 0 0 0 0 
0 0 0 0 8 0 8 0 0 5 8 0 8 0 0 0 
0 0 0 4 8 5 5 4 0 0 5 4 0 0 0 0 
0 0 0 0 0 0 1 0 6 5 4 0 0 0 0 0 
0 0 4 0 4 5 8 6 0 5 0 8 4 0 0 0 
0 0 0 8 0 8 0 0 1 5 0 0 8 0 0 0 
0 0 0 0 4 8 0 5 5 8 4 4 0 0 0 0 
0 0 0 0 0 4 0 8 0 4 0 8 0 0 0 0 
0 0 0 0 0 0 8 0 8 8 8 0 0 0 0 0 
0 0 0 0 0 0 0 0 0 0 0 0 0 0 0 0 
0 0 0 0 0 0 0 0 0 0 0 0 0 0 0 0 
0 0 0 0 0 0 0 0 0 0 0 0 0 0 0 0 

0 0 0 0 0 0 0 0 0 0 0 0 0 0 0 0 
0 0 0 0 0 0 0 0 0 0 0 0 0 0 0 0 
0 0 0 0 0 0 0 0 0 0 0 0 0 0 0 0 
0 0 0 0 0 0 4 0 0 0 0 0 0 0 0 0 
0 0 0 0 0 4 0 4 0 8 0 0 0 0 0 0 
0 0 0 0 8 0 0 0 0 0 8 4 0 0 0 0 
0 0 0 0 0 5 0 5 0 5 0 0 0 0 0 0 
0 0 0 0 4 0 0 0 6 0 5 0 0 0 0 0 
0 0 8 0 0 0 0 6 0 5 0 0 4 0 0 0 
0 0 0 8 0 4 0 0 6 4 0 0 8 0 0 0 
0 0 0 0 0 0 8 0 5 8 0 4 0 0 0 0 
0 0 0 0 4 0 0 4 0 0 8 0 0 0 0 0 
0 0 0 0 0 0 8 0 0 8 0 0 0 0 0 0 
0 0 0 0 0 0 0 0 0 0 0 0 0 0 0 0 
0 0 0 0 0 0 0 0 0 0 0 0 0 0 0 0 
0 0 0 0 0 0 0 0 0 0 0 0 0 0 0 0 