16 16
0 0
80 1 0

16
255 255 255
4 4 9
216 210 192
46 32 60
57 64 127
236 217 152
166 138 125
70 138 200
108 66 87
188 250 251
86 41 66
192 118 53

0 0 0
0 0 0
0 0 0
0 0 0

1
256
0 1 1 0 0 0 0 1 1 0 0 0 0 1 1 0 
0 1 2 3 1 3 1 4 4 1 3 1 3 5 1 0 
0 1 5 5 6 1 4 1 1 3 1 6 5 6 1 0 
0 1 1 3 3 4 7 7 7 7 4 1 3 1 1 0 
0 0 1 1 4 7 4 7 7 4 7 4 1 1 0 0 
0 1 7 4 7 3 3 7 7 3 3 4 1 4 1 0 
1 7 4 3 7 6 8 4 4 8 6 4 1 3 4 1 
1 7 7 1 4 7 7 7 7 7 4 3 1 4 4 1 
1 4 7 4 1 7 3 7 7 3 4 1 3 4 3 1 
1 7 4 3 1 8 2 9 2 6 8 1 1 3 4 1 
1 7 7 7 3 1 4 7 7 4 1 1 4 4 4 1 
1 7 7 4 10 3 10 10 10 10 3 1 3 4 4 1 
1 4 7 1 3 10 11 5 6 11 10 1 1 4 3 1 
0 1 1 1 1 1 3 3 1 1 3 1 1 1 1 0 
0 0 0 1 8 1 1 0 0 0 1 8 1 1 0 0 
0 0 0 1 0 1 1 0 0 0 1 3 0 1 0 0 